333333333333333333333333333333333333330000
333333333333333333333333333333333333330000
333333333333333333333333333333333333330000
333333333333333333333333333333333333330000
333333333333333333333333333333333333330000
333333333333333030000000333333333333330000
000000000000000000000000000000000000000000
003333333333333333333333333333333333000000
003334433333333333333333334433333333000000
003344433344443333333333333333333333000000
003333333333333333333333333333333333000000
003333333333333333333333333443333333000000
003333333333333333333333333443333333000000
003333333333333333333333333333333333000000
003333333333333333333333333333333333000000
003333333333333333333333333333333333000000
003333133333333133333333331333333333000000
000000000000000000000000000000000000000000