33333333333333333333333333333333333333333333333333333333333333331333333333333333
33333333333333333333444333333333333333333333333333333333333333300003333333333333
33333333334444433333444433344333333333333333333333333333333333000333333333333333
33333333333333333333333333333333333333344433333333333333333333003333333333333333
33333333333333333333333333333333333333444444433333333333330000033323333333333333
33333333333333333333133333333333333333333333333333333330000333333333333333333333
33333333330000000330003333333333333333333333333333333300033323333333333333333333
33331333000333333333300000003333333333333333333333330003333333333333333333333333
33000000033333333332333333300003333313333333000000000033333333333333333311300033
00003333233333333333333333333300000003333333332333333333333333333333300000003333
33333333333333332333333333333333333300000333333333323333333333233333333300333333
33333333333333333333332333333333323333333333333333333333333333333333333333332333